11111111
1C0P10E1
11111111
11111111
