1111111111111111
1P0C000000E00011
1000000000000001
1111111111111111